2 2 2 2 2 2 2 2 2 2 2 2 2 2 2 2 2 2 2 2 2 2 2 2 2 2 2 2 2 2 2 2 2 2 2 2 2 2 2 2 2 2 2 2 2 2 2 2 2 2 2 2 2 2
2 2 2 2 2 2 2 2 2 2 2 2 2 2 2 2 2 2 2 2 2 2 2 2 2 2 2 2 2 2 2 2 2 2 2 2 2 2 2 2 2 2 2 2 2 2 2 2 2 2 2 2 2 2
2 2 2 2 2 2 2 2 2 2 2 2 2 2 2 2 2 2 2 2 2 2 2 2 2 2 2 2 2 2 2 2 2 2 2 2 2 2 2 2 2 2 2 2 2 2 2 2 2 2 2 2 2 2
2 2 2 2 2 2 2 2 2 2 2 2 2 2 2 2 2 2 2 2 2 2 2 2 2 2 2 2 2 2 2 2 2 2 2 2 2 2 2 2 2 2 2 2 2 2 2 2 2 2 2 2 2 2
2 2 2 2 2 2 2 2 2 2 2 2 2 2 2 2 2 2 2 2 2 2 2 2 2 2 2 2 2 2 2 2 2 2 2 2 2 2 2 2 2 2 2 2 2 2 2 2 2 2 2 2 2 2
2 2 2 2 2 2 2 2 2 2 2 2 1 1 1 1 1 1 1 1 1 1 1 1 1 1 1 1 1 2 2 2 2 2 2 2 2 2 2 2 2 2 2 2 2 2 2 2 2 2 2 2 2 2
2 2 2 2 2 2 2 2 2 2 2 2 1 5 5 4 4 3 3 3 4 5 5 5 1 1 5 5 1 2 2 2 2 2 2 2 2 2 2 2 2 2 2 2 2 2 2 2 2 2 2 2 2 2
2 2 2 2 2 2 2 2 2 2 2 2 1 5 5 5 3 3 3 3 5 5 5 5 5 5 5 5 1 2 2 2 2 2 2 2 2 2 2 2 2 2 2 2 2 2 2 2 2 2 2 2 2 2
2 2 2 2 2 2 2 2 2 2 2 2 1 5 5 5 3 3 3 3 5 5 5 5 5 5 5 5 1 2 2 2 2 2 2 2 2 2 2 2 2 2 2 2 2 2 2 2 2 2 2 2 2 2
2 2 2 2 2 2 2 2 2 2 2 2 1 5 5 5 1 3 3 3 5 5 5 5 1 1 5 5 1 2 2 2 2 2 2 2 2 2 2 2 2 2 2 2 2 2 2 2 2 2 2 2 2 2
2 2 2 2 2 2 2 1 1 1 1 1 1 5 5 5 1 3 3 3 5 5 5 5 1 1 5 5 1 1 1 1 1 1 1 1 1 1 1 2 2 2 2 2 2 2 2 2 2 2 2 2 2 2
2 2 2 2 2 2 2 1 5 5 5 5 5 5 5 5 1 1 1 1 1 5 5 1 1 1 5 5 1 5 5 5 5 5 5 5 5 5 1 2 2 2 2 2 2 2 2 2 2 2 2 2 2 2
2 2 2 2 2 2 2 1 5 5 5 5 5 5 5 5 1 1 1 1 1 5 5 5 1 1 5 5 5 5 5 5 5 5 5 5 5 5 1 1 1 2 2 2 2 2 2 2 2 2 2 2 2 2
2 2 2 2 2 2 2 1 5 5 1 1 1 5 5 5 5 5 5 5 1 5 5 5 1 1 5 5 5 5 5 5 5 5 5 5 5 5 5 5 1 2 2 2 2 2 2 2 2 2 2 2 2 2
2 2 2 2 2 2 2 1 5 5 1 1 1 5 5 5 5 5 5 5 5 5 5 5 1 1 5 5 1 5 5 5 5 5 5 5 5 5 5 5 1 2 2 2 2 2 2 2 2 2 2 2 2 2
2 2 2 2 2 2 2 1 5 5 1 1 1 1 1 1 5 5 5 5 5 5 5 5 1 1 1 1 1 1 1 1 1 1 1 1 1 1 5 5 1 2 2 2 2 2 2 2 2 2 2 2 2 2
2 2 2 2 2 2 2 1 5 5 5 5 5 5 5 5 5 5 5 5 1 5 5 5 1 1 1 1 1 1 1 1 1 1 1 1 1 1 5 5 1 2 2 2 2 2 2 2 2 2 2 2 2 2
2 2 2 2 2 2 2 1 5 5 5 5 5 5 5 5 5 5 5 5 1 5 5 5 1 1 1 1 1 1 1 1 1 1 1 1 1 1 5 5 1 1 1 1 1 1 1 2 2 2 2 2 2 2
2 2 2 2 2 2 2 1 5 5 1 1 1 1 1 1 1 1 1 1 1 5 5 5 5 5 5 5 1 1 1 1 1 1 1 1 1 1 5 5 5 0 4 4 4 4 1 2 2 2 2 2 2 2
2 2 2 2 2 2 2 1 5 5 1 1 1 1 1 1 1 1 1 1 1 5 5 5 5 5 5 5 1 1 1 1 1 1 1 1 1 1 5 5 5 5 5 5 5 4 1 2 2 2 2 2 2 2
2 2 2 2 2 2 2 1 5 5 1 1 1 1 1 1 1 1 1 1 1 1 1 1 1 1 5 5 5 5 5 5 5 5 5 5 5 5 5 5 1 0 5 5 5 4 1 2 2 2 2 2 2 2
2 2 2 2 2 2 2 1 5 5 1 1 1 1 1 1 1 1 1 1 1 1 1 1 1 1 5 5 5 5 5 5 5 5 5 5 5 5 5 5 1 4 5 5 5 4 1 2 2 2 2 2 2 2
2 2 2 2 2 2 2 1 5 5 1 1 1 1 1 1 1 1 1 1 1 1 1 1 1 1 5 5 5 5 5 5 5 5 1 1 1 1 1 1 1 4 5 5 5 4 1 2 2 2 2 2 2 2
2 2 2 2 2 2 2 1 5 5 1 1 1 1 1 1 1 1 1 1 1 1 1 1 1 1 5 5 5 5 5 5 5 5 1 1 1 1 1 1 1 4 5 5 5 4 1 2 2 2 2 2 2 2
2 2 2 2 2 2 2 1 5 5 5 5 5 5 5 5 5 5 5 5 5 5 5 5 5 5 5 5 5 5 5 5 5 5 1 1 1 1 1 1 1 4 5 5 5 4 1 2 2 2 2 2 2 2
2 2 2 2 2 2 2 1 5 5 5 5 5 5 5 5 5 5 5 5 5 5 5 5 5 5 5 5 5 5 5 5 5 5 1 1 1 1 1 1 1 4 5 5 5 4 1 2 2 2 2 2 2 2
2 2 2 2 2 2 2 1 5 5 1 1 1 5 5 1 1 1 1 1 1 5 5 5 5 5 5 5 5 5 5 5 5 5 1 1 1 1 1 1 1 4 5 5 5 4 1 2 2 2 2 2 2 2
2 2 2 2 2 2 2 1 5 5 1 1 1 5 5 5 5 1 1 1 1 5 5 5 5 5 5 5 5 5 5 5 5 5 1 1 1 1 1 1 1 4 5 5 5 4 1 2 2 2 2 2 2 2
2 2 2 2 2 2 2 1 5 5 1 1 1 5 5 5 5 1 1 1 1 5 5 5 5 5 5 5 5 5 5 5 5 5 1 1 1 1 1 1 1 4 5 5 5 4 1 2 2 2 2 2 2 2
2 2 2 2 2 2 2 1 5 5 1 1 1 5 5 5 5 1 1 1 1 5 5 5 5 5 5 5 5 5 5 5 5 5 1 1 1 1 1 1 1 4 5 5 5 4 1 2 2 2 2 2 2 2
2 2 2 2 2 2 2 1 5 5 1 1 1 5 4 1 1 1 1 1 1 1 1 1 1 1 1 1 1 1 1 5 5 1 1 1 1 1 1 1 1 4 5 5 5 4 1 2 2 2 2 2 2 2
2 2 2 2 2 2 2 1 5 5 1 1 5 5 4 5 1 1 5 5 5 1 1 1 1 1 1 1 1 1 1 5 5 5 5 1 1 1 1 1 1 4 5 5 5 4 1 2 2 2 2 2 2 2
2 2 2 2 2 2 2 1 5 5 1 1 5 5 4 5 5 5 5 5 5 1 1 1 1 1 1 1 1 1 1 5 5 5 5 1 1 1 1 1 1 4 5 5 5 4 1 2 2 2 2 2 2 2
2 2 2 2 2 2 2 1 5 5 5 5 5 4 4 5 5 5 5 5 5 1 1 1 1 1 1 1 1 1 1 5 5 1 1 1 1 1 1 1 1 4 5 5 5 4 1 2 2 2 2 2 2 2
2 2 2 2 2 2 2 1 5 5 5 5 5 5 5 5 5 1 5 5 1 1 1 1 1 1 1 1 1 1 1 5 5 5 5 5 5 1 2 2 1 4 5 5 5 4 1 2 2 2 2 2 2 2
2 2 2 2 2 2 2 1 5 5 1 5 4 5 5 4 5 1 5 5 1 1 1 1 1 1 1 1 1 1 1 5 5 5 5 5 5 1 2 2 1 4 5 5 5 4 1 2 2 2 2 2 2 2
2 2 2 2 2 2 2 1 5 5 1 5 4 5 5 4 5 1 5 5 1 1 1 1 1 1 1 1 1 1 1 5 5 5 5 5 5 1 2 2 1 4 5 5 5 4 1 2 2 2 2 2 2 2
2 2 2 2 2 2 2 1 5 5 1 5 4 4 4 4 5 1 5 5 1 1 1 1 1 1 1 1 1 1 1 5 5 5 5 5 5 1 2 2 1 4 5 5 5 4 1 2 2 2 2 2 2 2
2 2 2 2 2 2 2 1 1 1 1 3 3 3 3 4 3 1 5 5 5 5 5 5 5 5 5 5 5 5 5 5 5 5 5 5 5 1 2 2 1 4 5 5 5 4 1 2 2 2 2 2 2 2
2 2 2 2 2 2 2 2 2 2 1 3 3 3 3 4 3 1 5 5 5 5 5 5 5 5 5 5 5 5 5 5 5 5 5 5 5 1 2 2 1 4 5 5 5 4 1 2 2 2 2 2 2 2
2 2 2 2 2 2 2 2 2 2 1 3 3 3 3 4 3 1 1 1 1 1 1 1 1 1 1 1 1 1 1 1 1 1 1 1 1 1 2 2 1 4 5 5 5 4 1 2 2 2 2 2 2 2
2 2 2 2 2 2 2 2 2 2 1 1 5 1 1 1 5 1 2 2 2 2 2 2 2 2 2 2 2 2 2 2 2 2 2 2 2 1 2 2 1 4 5 5 5 4 1 2 2 2 2 2 2 2
2 2 2 2 2 2 2 2 2 2 1 5 5 5 5 5 5 1 2 2 2 2 2 2 2 2 2 2 2 2 2 2 2 2 2 2 2 1 2 2 1 4 5 5 5 4 1 2 2 2 2 2 2 2
2 2 2 2 2 2 2 2 2 2 1 5 5 5 5 5 5 1 2 2 2 2 2 2 2 2 2 2 2 2 2 2 2 2 2 2 2 1 2 2 1 4 4 4 4 4 1 2 2 2 2 2 2 2
2 2 2 2 2 2 2 2 2 2 1 1 1 1 1 1 1 1 2 2 2 2 2 2 2 2 2 2 2 2 2 2 2 2 2 2 2 1 1 1 1 1 1 1 1 1 1 2 2 2 2 2 2 2
2 2 2 2 2 2 2 2 2 2 2 2 2 2 2 2 2 2 2 2 2 2 2 2 2 2 2 2 2 2 2 2 2 2 2 2 2 2 2 2 2 2 2 2 2 2 2 2 2 2 2 2 2 2
2 2 2 2 2 2 2 2 2 2 2 2 2 2 2 2 2 2 2 2 2 2 2 2 2 2 2 2 2 2 2 2 2 2 2 2 2 2 2 2 2 2 2 2 2 2 2 2 2 2 2 2 2 2
2 2 2 2 2 2 2 2 2 2 2 2 2 2 2 2 2 2 2 2 2 2 2 2 2 2 2 2 2 2 2 2 2 2 2 2 2 2 2 2 2 2 2 2 2 2 2 2 2 2 2 2 2 2
2 2 2 2 2 2 2 2 2 2 2 2 2 2 2 2 2 2 2 2 2 2 2 2 2 2 2 2 2 2 2 2 2 2 2 2 2 2 2 2 2 2 2 2 2 2 2 2 2 2 2 2 2 2
2 2 2 2 2 2 2 2 2 2 2 2 2 2 2 2 2 2 2 2 2 2 2 2 2 2 2 2 2 2 2 2 2 2 2 2 2 2 2 2 2 2 2 2 2 2 2 2 2 2 2 2 2 2